S..##########
............#
#..#######..#
#..#.....#..#
####..####..#
#F..........#
#..#######..#
#........#..
##########..

